1111111111111
1000010010001
101P00C000CC1
1EC0C010C1C01
1000C000C0001
10100C00C0C01
1111111111111