111111111
1E000P001
100000C01
111111111