11111111111111111111
10000011CC0010010001
101P0000CC000C000CC1
1001C000EC0C010C1C01
1000C000C000CC1C0001
10100C00C0C000011001
11111111111111111111