11111111111111111111111111
1P000000000000000000000001
10111111110111111111111111
1000C000000000000000C00001
10000000000000000000000C01
10000000000000000000000C01
10000000000000000000000C01
10000000000000000000000C01
10000000000000000000000C01
10000000000000000000000C01
10000000000000000000000C01
10000000000000000000000C01
10000000000000000000000C01
10000000000000000000000C01
10000000000000000000000C01
10000000000000000000000C01
10000000000000000000000C01
10000000000000000000000C01
10000000000000000000000C01
10000000000000000000000C01
10000000000000000000000C01
10000000000000000000000C01
10000000000000000000000C01
10000000000000000000000C01
10000000000000000000000C01
10000000000000000000000C01
10000000000000000000000C01
10000000000000000000000C01
10000000000000000000000C01
10000000000000000000000C01
10000000000000000000000C01
10000000000000000000000C01
10000000000000000000000C01
10000000000000000000000C01
10000000000000000000000C01
10000000000000000000000C01
10000000000000000000000C01
10000000000000000000000C01
10000000000000000000000C01
1E000000000000000000000C01
10000000000000000000000C01
10000000000000000000000C01
10000000000000000000000C01
10000000000000000000000C01
10000000000000000000000C01
10000000000000000000000C01
10000000000000000000000C01
10000000000000000000000C01
11111111111111111111111111