1111111111
10P00C00E1
1010111001
100C000001
1111111111