1111111111111111111
1P00000000000000001
1011111111011111111
1000C00000000C00001
1011111011111011111
1000001010000010001
1111011010111110111
1000010000000000C01
1011111011111111011
10000000C00000000E1
1111111111111111111