111111
10CP01
1000C1
1E1101
111111